 _      _____ _   _ _____ _                 _____ 
| |    |  ___| | | |  ___| |               |____ |
| |    | |__ | | | | |__ | |                   / /
| |    |  __|| | | |  __|| |                   \ \
| |____| |___\ \_/ / |___| |____           .___/ /
\_____/\____/ \___/\____/\_____/           \____/ 
                                                  
                                                  