..............
.c..####...c..
....####......
..............
..#.....p.....
..#...........
..#...........
..#########...
..c...........