...............................................
..p.######..........c..........................
....#######....................................
....#######....................................
....######.......######........................
.................######........c...............
.................######........................
.................######........................
...............................................
..................................#####........
..................................#####........
..................................#####........
..................................#####........
...............#######.........................
...............#######.........................
...............................................
...............#######.........................
..............#########........................
..............#########........................
...............#######....b....................
...............................................




















